111111111111
10CEP0100101
111111111111
