111111111111
100100100001
100000000CE1
000000000000
