111111111111
100E00100101
100000P00C11
111111111111