111111111111
100100100101
1000E0001C11
10000P000001
100000000101
100000001E11
100000000101
111111111111