1111111111111111
1000100C000000E1
10000100P00C0001
0000000000000001
1111111111111111