111111111111
100100100001
1000P0000CE1
111111111111