11111111111111111111111111
10000000000000000000000001
1010001C0000001000000000C1
101C1010101C10000000000001
10001C00000000000100100001
10000P000000000000000000E1
10000000000000000000000001
11111111111111111111111111