1111111111111111
1000000000000001
1P10001C001000C1
101C1010101C1001
10001C0010001001
10000000E0000001
1111111111111111