111111111111
100P00E0C001
111111111111
